         ID          	 Length 	   GC   	   N    	GC_ratio	N_ratio 	   A    	   T    	   C    	   G    
        CHR1         	249250621	94040974	23970000	 0.377  	 0.096  	65570891	65668756	47024412	47016562
CHR1_GL000191_RANDOM 	 106433 	 47198  	   0    	 0.443  	 0.000  	 27971  	 31264  	 23785  	 23413  
CHR1_GL000192_RANDOM 	 547496 	 227171 	   0    	 0.415  	 0.000  	 163078 	 157247 	 112730 	 114441 
        CHR2         	243199373	95862507	4994855 	 0.394  	 0.021  	71102632	71239379	47915465	47947042
        CHR3         	198022430	77323307	3225295 	 0.390  	 0.016  	58713343	58760485	38653197	38670110
        CHR4         	191154276	71776628	3492600 	 0.375  	 0.018  	57932980	57952068	35885806	35890822
   CHR4_CTG9_HAP1    	 590426 	 214768 	   0    	 0.364  	 0.000  	 185171 	 190487 	 107556 	 107212 
CHR4_GL000193_RANDOM 	 189789 	 81224  	   0    	 0.428  	 0.000  	 53509  	 55056  	 40616  	 40608  
CHR4_GL000194_RANDOM 	 191469 	 82827  	   0    	 0.433  	 0.000  	 52949  	 55693  	 41521  	 41306  
        CHR5         	180915260	70218569	3220000 	 0.388  	 0.018  	53672554	53804137	35089383	35129186
        CHR6         	171115067	66306710	3720001 	 0.387  	 0.022  	50554433	50533923	33143287	33163423
    CHR6_APD_HAP1    	4622290 	1019557 	2301543 	 0.221  	 0.498  	 660350 	 640840 	 509167 	 510390 
    CHR6_COX_HAP2    	4795371 	2142565 	   0    	 0.447  	 0.000  	1341236 	1311570 	1069806 	1072759 
    CHR6_DBB_HAP3    	4610396 	1888816 	 406094 	 0.410  	 0.088  	1172535 	1142951 	 943550 	 945266 
   CHR6_MANN_HAP4    	4683263 	1810464 	 582522 	 0.387  	 0.124  	1156084 	1134193 	 903022 	 907442 
    CHR6_MCF_HAP5    	4833398 	1719716 	1038487 	 0.356  	 0.215  	1050968 	1024227 	 858581 	 861135 
    CHR6_QBL_HAP6    	4611984 	1936945 	 316659 	 0.420  	 0.069  	1189669 	1168711 	 967043 	 969902 
   CHR6_SSTO_HAP7    	4928567 	1845164 	 755016 	 0.374  	 0.153  	1172219 	1156168 	 918220 	 926944 
        CHR7         	159138663	63308649	3785000 	 0.398  	 0.024  	45997757	46047257	31671670	31636979
CHR7_GL000195_RANDOM 	 182896 	 74370  	   0    	 0.407  	 0.000  	 53469  	 55057  	 37021  	 37349  
        CHR8         	146364022	57406604	3475100 	 0.392  	 0.024  	42767293	42715025	28703983	28702621
CHR8_GL000196_RANDOM 	 38914  	 15429  	   0    	 0.396  	 0.000  	 13843  	  9642  	  7910  	  7519  
CHR8_GL000197_RANDOM 	 37175  	 20023  	  100   	 0.539  	 0.003  	  8644  	  8408  	  9883  	 10140  
        CHR9         	141213431	49639471	21070000	 0.352  	 0.149  	35260078	35243882	24826212	24813259
CHR9_GL000198_RANDOM 	 90085  	 34102  	   0    	 0.379  	 0.000  	 27843  	 28140  	 15617  	 18485  
CHR9_GL000199_RANDOM 	 169874 	 64407  	   0    	 0.379  	 0.000  	 54702  	 50765  	 34981  	 29426  
CHR9_GL000200_RANDOM 	 187035 	 74716  	   0    	 0.399  	 0.000  	 55353  	 56966  	 37202  	 37514  
CHR9_GL000201_RANDOM 	 36148  	 21487  	   0    	 0.594  	 0.000  	  7101  	  7560  	 10373  	 11114  
        CHR10        	135534747	54607071	4220009 	 0.403  	 0.031  	38330752	38376915	27308648	27298423
        CHR11        	135006516	54504836	3877000 	 0.404  	 0.029  	38307244	38317436	27236798	27268038
CHR11_GL000202_RANDOM	 40103  	 21899  	   0    	 0.546  	 0.000  	  9226  	  8978  	 11254  	 10645  
        CHR12        	133851895	53252045	3370502 	 0.398  	 0.025  	38604831	38624517	26634995	26617050
        CHR13        	115169878	36827474	19580000	 0.320  	 0.170  	29336945	29425459	18412698	18414776
        CHR14        	107349540	36099079	19060000	 0.336  	 0.178  	25992966	26197495	18027132	18071947
        CHR15        	102531392	34475969	20836626	 0.336  	 0.203  	23620876	23597921	17247582	17228387
        CHR16        	90354753	35332028	11470000	 0.391  	 0.127  	21724083	21828642	17630040	17701988
        CHR17        	81195210	35428296	3400000 	 0.436  	 0.042  	21159933	21206981	17727956	17700340
   CHR17_CTG5_HAP1   	1680828 	 718692 	 100000 	 0.428  	 0.059  	 429214 	 432922 	 355909 	 362783 
CHR17_GL000203_RANDOM	 37498  	 12482  	   0    	 0.333  	 0.000  	 12564  	 12452  	  6074  	  6408  
CHR17_GL000204_RANDOM	 81310  	 44286  	   0    	 0.545  	 0.000  	 19702  	 17322  	 22701  	 21585  
CHR17_GL000205_RANDOM	 174588 	 72862  	   0    	 0.417  	 0.000  	 49255  	 52471  	 36716  	 36146  
CHR17_GL000206_RANDOM	 41001  	 21768  	   0    	 0.531  	 0.000  	  8770  	 10463  	 10483  	 11285  
        CHR18        	78077248	29702356	3420019 	 0.380  	 0.044  	22465380	22489493	14838685	14863671
CHR18_GL000207_RANDOM	  4262  	  1873  	   0    	 0.439  	 0.000  	  1004  	  1385  	  588   	  1285  
        CHR19        	59128983	26989400	3320000 	 0.456  	 0.056  	14390632	14428951	13478255	13511145
CHR19_GL000208_RANDOM	 92689  	 34908  	   0    	 0.377  	 0.000  	 29179  	 28602  	 18369  	 16539  
CHR19_GL000209_RANDOM	 159169 	 74008  	   0    	 0.465  	 0.000  	 43978  	 41183  	 35443  	 38565  
        CHR20        	63025520	26257240	3520000 	 0.417  	 0.056  	16523053	16725227	13107828	13149412
        CHR21        	48129895	14334933	13023253	 0.298  	 0.271  	10422924	10348785	7160212 	7174721 
CHR21_GL000210_RANDOM	 27682  	 14977  	  100   	 0.541  	 0.004  	  6288  	  6317  	  7726  	  7251  
        CHR22        	51304566	16745219	16410021	 0.326  	 0.320  	9094775 	9054551 	8375984 	8369235 
        CHRM         	 16571  	  7372  	   0    	 0.445  	 0.000  	  5113  	  4086  	  5192  	  2180  
   CHRUN_GL000211    	 166566 	 64475  	   0    	 0.387  	 0.000  	 50926  	 51165  	 31968  	 32507  
   CHRUN_GL000212    	 186858 	 82936  	   0    	 0.444  	 0.000  	 52729  	 51193  	 42454  	 40482  
   CHRUN_GL000213    	 164239 	 67177  	   0    	 0.409  	 0.000  	 48047  	 49015  	 33831  	 33346  
   CHRUN_GL000214    	 137718 	 57182  	   0    	 0.415  	 0.000  	 40645  	 39891  	 27484  	 29698  
   CHRUN_GL000215    	 172545 	 72473  	   0    	 0.420  	 0.000  	 50334  	 49738  	 36250  	 36223  
   CHRUN_GL000216    	 172294 	 72319  	   0    	 0.420  	 0.000  	 41409  	 58566  	 46717  	 25602  
   CHRUN_GL000217    	 172149 	 64709  	   0    	 0.376  	 0.000  	 51945  	 55495  	 32578  	 32131  
   CHRUN_GL000218    	 161147 	 67070  	   0    	 0.416  	 0.000  	 46030  	 48047  	 33296  	 33774  
   CHRUN_GL000219    	 179198 	 71609  	   0    	 0.400  	 0.000  	 54530  	 53059  	 35501  	 36108  
   CHRUN_GL000220    	 161802 	 78417  	   0    	 0.485  	 0.000  	 37230  	 46155  	 40720  	 37697  
   CHRUN_GL000221    	 155397 	 60038  	   0    	 0.386  	 0.000  	 47915  	 47444  	 29886  	 30152  
   CHRUN_GL000222    	 186861 	 82170  	   0    	 0.440  	 0.000  	 51533  	 53158  	 40866  	 41304  
   CHRUN_GL000223    	 180455 	 77956  	   0    	 0.432  	 0.000  	 52931  	 49568  	 38849  	 39107  
   CHRUN_GL000224    	 179693 	 77785  	   0    	 0.433  	 0.000  	 50248  	 51660  	 37430  	 40355  
   CHRUN_GL000225    	 211173 	 100631 	   0    	 0.477  	 0.000  	 56943  	 53599  	 48931  	 51700  
   CHRUN_GL000226    	 15008  	  5857  	   0    	 0.390  	 0.000  	  4502  	  4649  	  2626  	  3231  
   CHRUN_GL000227    	 128374 	 52646  	   0    	 0.410  	 0.000  	 41076  	 34652  	 26250  	 26396  
   CHRUN_GL000228    	 129120 	 69641  	   0    	 0.539  	 0.000  	 30512  	 28967  	 35495  	 34146  
   CHRUN_GL000229    	 19913  	  9986  	   0    	 0.501  	 0.000  	  3983  	  5944  	  5385  	  4601  
   CHRUN_GL000230    	 43691  	 18224  	   0    	 0.417  	 0.000  	 12678  	 12789  	  9338  	  8886  
   CHRUN_GL000231    	 27386  	 12232  	   0    	 0.447  	 0.000  	  7100  	  8054  	  6203  	  6029  
   CHRUN_GL000232    	 40652  	 17002  	   0    	 0.418  	 0.000  	 11534  	 12116  	  8490  	  8512  
   CHRUN_GL000233    	 45941  	 19489  	   0    	 0.424  	 0.000  	 12192  	 14260  	  9504  	  9985  
   CHRUN_GL000234    	 40531  	 17457  	   0    	 0.431  	 0.000  	 10797  	 12277  	  8725  	  8732  
   CHRUN_GL000235    	 34474  	 13099  	   0    	 0.380  	 0.000  	 11845  	  9530  	  6585  	  6514  
   CHRUN_GL000236    	 41934  	 17458  	   0    	 0.416  	 0.000  	 13006  	 11470  	  8432  	  9026  
   CHRUN_GL000237    	 45867  	 21403  	   0    	 0.467  	 0.000  	 12273  	 12191  	 10241  	 11162  
   CHRUN_GL000238    	 39939  	 15976  	   0    	 0.400  	 0.000  	 10404  	 13559  	  7805  	  8171  
   CHRUN_GL000239    	 33824  	 15357  	   0    	 0.454  	 0.000  	  9221  	  9246  	  7268  	  8089  
   CHRUN_GL000240    	 41933  	 17842  	   0    	 0.425  	 0.000  	 13601  	 10490  	  8962  	  8880  
   CHRUN_GL000241    	 42152  	 15717  	   0    	 0.373  	 0.000  	 13620  	 12815  	  7864  	  7853  
   CHRUN_GL000242    	 43523  	 21063  	   0    	 0.484  	 0.000  	 10591  	 11869  	 10033  	 11030  
   CHRUN_GL000243    	 43341  	 19940  	   0    	 0.460  	 0.000  	 10728  	 12673  	 10304  	  9636  
   CHRUN_GL000244    	 39929  	 17421  	   0    	 0.436  	 0.000  	 10948  	 11560  	  8564  	  8857  
   CHRUN_GL000245    	 36651  	 13309  	   0    	 0.363  	 0.000  	 12875  	 10467  	  6707  	  6602  
   CHRUN_GL000246    	 38154  	 14746  	   0    	 0.386  	 0.000  	 10440  	 12968  	  7354  	  7392  
   CHRUN_GL000247    	 36422  	 15880  	   0    	 0.436  	 0.000  	 11002  	  9540  	  7794  	  8086  
   CHRUN_GL000248    	 39786  	 18165  	   0    	 0.457  	 0.000  	 10114  	 11507  	  9265  	  8900  
   CHRUN_GL000249    	 38502  	 18011  	   0    	 0.468  	 0.000  	 10793  	  9698  	  8978  	  9033  
        CHRX         	155270560	59679184	4170000 	 0.384  	 0.027  	45648952	45772424	29813353	29865831
        CHRY         	59373566	10252459	33720000	 0.173  	 0.568  	7667625 	7733482 	5099171 	5153288 
